111111111111111
1000C0000000001
100000000000C01
100P01111000001
100000001000001
1000C0000000001
111111000000001
100000000100001
1001E0000100C01
111111111111111